######
##A  #
#### #
#    #
# ### 
#  B #
######